56 6 55 55 55 6 56 56 56 5 56 56 6 4 4 57 5 4 55 55 5 5 57 6 6
6 6 4 5 5 56 57 6 6 5 56 55 5 57 55 4 55 55 4 6 57 57 57 56 6
6 55 55 56 57 6 57 6 57 56 56 55 57 57 57 5 56 5 5 56 57 56 57 57 4
56 57 56 56 56 5 6 56 56 57 4 57 56 57 56 56 5 5 55 57 5 5 57 6 5
56 5 56 57 57 56 57 5 56 5 56 57 57 56 5 57 57 6 57 56 6 55 6 57 57
57 6 55 4 57 55 57 56 55 5 56 55 55 56 4 55 4 4 4 57 4 4 4 4 5
5 56 55 6 6 6 56 57 57 56 56 55 55 56 4 5 57 55 57 5 5 56 5 4 57
55 57 4 6 4 5 6 6 57 56 5 4 4 6 5 4 56 4 5 4 56 56 5 57 4
5 55 6 56 55 56 55 55 4 4 5 4 56 55 55 55 55 4 56 57 4 5 56 5 5
5 57 56 56 4 56 55 57 57 56 4 57 4 6 55 56 55 55 5 5 5 56 4 4 4
57 6 5 55 5 6 6 4 55 4 6 4 57 6 5 5 4 4 4 6 57 56 4 4 55
5 55 55 5 6 56 4 4 4 5 57 6 5 6 5 56 56 6 5 55 4 5 56 5 5
4 4 6 5 55 4 5 4 55 55 56 5 57 6 5 4 6 4 6 4 6 4 4 5 7
57 56 56 6 55 56 57 55 4 57 55 4 4 56 5 4 5 6 56 56 4 56 4 6 56
5 6 5 55 6 5 4 5 6 4 6 56 5 57 6 6 55 56 56 4 56 56 5 4 57
57 55 55 55 57 56 5 55 4 55 4 5 55 6 55 56 55 4 55 56 5 6 5 57 6
6 55 56 56 5 56 5 4 55 4 55 4 4 57 4 4 6 56 4 4 55 55 55 56 6
6 6 56 4 6 5 56 5 5 5 55 5 6 57 55 4 4 5 55 6 5 56 55 56 57
57 57 4 57 4 57 57 4 56 5 57 4 6 55 4 55 57 57 5 57 5 55 5 5 55
55 55 4 5 5 4 56 4 55 5 6 55 5 55 5 6 4 4 57 6 5 5 55 5 56
5 57 56 57 4 57 57 6 6 6 6 6 55 4 4 4 6 6 6 6 5 57 57 4 5
56 4 6 4 6 56 5 55 4 6 5 6 57 57 57 4 6 57 55 5 55 57 6 55 56
56 56 4 5 56 5 6 55 56 55 5 5 56 55 4 55 5 57 5 6 4 5 4 56 5
6 6 6 6 5 55 6 56 5 55 4 56 56 4 55 5 57 5 57 55 56 6 56 57 6
4 57 5 4 57 4 6 56 4 6 4 5 55 6 56 55 5 6 4 6 6 56 4 4 6
