116 100 101 99 116 116 114 115 100 114 100 115 100 115 99 100 99 101 115 116 116 100 115 114 101
115 100 116 100 100 101 99 99 99 100 100 100 115 101 114 115 116 100 101 101 101 101 100 114 114
100 99 100 101 99 114 99 116 116 114 100 100 116 114 115 100 99 101 101 114 116 100 99 99 114
116 99 115 100 114 101 101 101 115 115 100 116 114 115 114 116 115 114 101 100 99 101 115 115 99
116 100 114 115 100 100 115 100 99 115 99 100 100 100 114 116 114 116 115 99 100 114 115 114 101
114 115 114 114 101 101 99 101 99 116 114 99 116 114 100 116 115 116 115 116 101 114 114 116 100
100 116 116 114 114 116 114 116 101 99 116 116 100 115 116 100 99 99 101 114 100 101 115 101 114
115 116 99 100 100 114 100 114 114 115 99 100 114 99 115 101 100 99 116 101 101 114 100 100 114
101 116 100 101 101 100 100 114 100 99 99 99 99 99 101 116 101 100 101 101 99 100 101 114 101
99 114 101 99 114 99 115 114 100 100 101 99 115 100 116 115 100 99 99 99 115 116 114 116 99
115 116 99 114 101 116 100 99 101 99 99 99 99 114 101 115 115 116 100 100 114 101 115 101 100
99 100 101 116 99 99 101 101 116 101 101 101 99 101 101 100 99 101 100 100 101 100 100 116 102
99 100 100 101 99 115 100 115 101 99 101 100 99 116 114 100 100 101 114 101 114 99 99 101 101
115 101 99 115 115 116 115 115 115 114 115 114 99 115 115 99 116 100 100 115 99 100 101 116 116
116 99 116 115 115 114 99 99 99 100 100 115 99 115 115 99 114 101 100 101 114 114 101 100 101
101 101 101 114 116 114 101 116 114 101 99 114 115 100 101 115 100 100 99 99 100 114 100 101 100
99 116 101 115 100 116 114 115 99 101 101 100 101 114 115 114 116 115 101 116 99 100 99 116 114
114 100 114 101 115 101 116 114 115 100 99 100 99 99 115 101 114 101 101 100 116 100 115 100 99
101 100 115 116 99 114 101 115 116 114 99 115 101 99 115 115 99 114 115 100 100 114 101 115 115
100 100 115 101 115 116 114 101 101 116 101 116 101 115 114 101 99 99 99 115 116 116 115 100 99
114 100 100 100 100 99 99 100 114 101 99 100 115 99 116 114 100 101 114 101 100 115 99 116 115
116 115 101 99 101 115 115 115 116 116 115 114 116 114 116 116 99 116 100 101 100 115 116 116 101
101 114 101 116 116 99 101 114 101 114 115 115 115 114 116 116 116 114 100 101 115 100 99 101 114
99 114 114 115 115 99 99 116 101 101 116 101 114 115 101 114 101 116 99 99 100 99 115 116 101
101 100 100 99 101 101 115 114 100 116 115 114 115 100 99 114 100 101 116 114 115 101 116 99 116
